8.8
w.w.w.p.w.w.w.w
w.w.w.f.f.b.g.w
w.w.w.f.w.w.w.w
g.b.f.f.f.f.f.w
w.f.w.w.f.w.f.w
w.b.w.w.f.b.b.g
g.f.f.f.f.w.f.w
w.w.w.w.f.f.f.g